#########################################
#S  # # #       #   # # #   # #   # #   #
# ### # ##### ##### # # # # # ### # # # #
#         #         #   # #     #     # #
# ############# ### # ### ##### ### # # #
# #       # # # # #   #   #         # # #
# # ### # # # ### ### ##### ########### #
#     # #   #   #   #           #   #   #
# # # # # # # # ### ### ### ##### ### # #
# # # # # #   #           #         # # #
################### ### ### ### ### #####
#   #     # # #     # #   # #   # #     #
# # ### # # # # ##### # ##### ### ### ###
# # # # # #   # #       # #       # # # #
### # # ### # # ### ### # # ####### # # #
#       #   # #   # #   # # # # #   # # #
# ### ### ### # ### ##### ### # ### # # #
#   #     #       #     #   #           #
# ### ### ### # ### # # # ##### # ### ###
# #   #     # #   # # #   #     # #    E#
#########################################